11111111111111
10011000000CC1
1000C1111100C1
1P0011EC0000C1
1000000C0000C1
11111111111111