111111111
1111111C1
111111101
11E1111C1
1100P0001
111111111
