11111111111111
10011000000CC1
1000C1111000C1
1P0011EC00C0C1
1000000C0000C1
11111111111111
