11111111111111111
10000CCCCC0000001
10011CCC000000CC1
1000C1111000C00C1
1P000C011EC00C0C1
1000000000C0000C1
11111111111111111
