1111111111111111111
10000CCCCC0000CC001
10111CCC00000CC0CC1
1010C1111000C0CC0C1
1P100C011EC0CC0C0C1
1010001010C010CC0C1
1CCCCCCCCCCCCCCCCC1
1111111111111111111